F 111,110,111

C 102,190,204



NO ./asset/rigolage.xpm
SO ./asset/mario.xpm
WE ./asset/linux.xpm
EA ./asset/simpson.xpm


1111111111111111111111111
1000000000110000000000001
1011000001110000000000001
1001000000000000000000001
1001000000000000000000001
1001000000000000000000001
1001000000000000000000001
100100000N000000000000001
1001000000000000000000001
1001000000000000000000001
1111111111111111111111111
